|||||||||||||||||||||||||||||||||||||||||||||||||||
|   |       |   #####       |         |       |   |
| | ||| ||| ||||||||||| ||| | ||||||| ||| |||||   |
| |   | | |           | | |   |     |     |   |   |
| ||| | | |||###||||| | | ||||| ||||||||||||| ||| |
| | |   |           | | | ##  |       |       | | |
| | ||||| ||| ||||||| | | | ||| ||| ||| ||| | | | |
| |         | |       | | |     |   |   | | |   | |
| | ||||||| ||| ||||||| ||||| ||| ||| ||| | ||| | |
| | |     |   |   |     |   |   |         | | | | |
| ||| ||| ||| ||| ||| ||| | ||| ||||||||||| | | | |
| |   |       | |   |     | |   | |       | |   | |
| | ||||||#|| | ||| ||| ||| ||| | | ||||| | | ||| |
| |    #|   | |   |   |   |   |   | |     | | |   |
| | | ##| ||| ||| ||| ||||||| ||| | ||| ||| | | |||
| | |## |    #  |   | |  ###  |   |   |     | | | |
| | |#  ||||||| | | | | ||#|||| ||||| ||||||| | | |
| | |#      |   | | |   |     |   | |       ##|   |
| ||||||||| | ||| ||||||| ||||||| | ||||| | ##||| |
| |#      | |     |     |       |   |   | | ##  | |
| | ||||| | ||||||| | ||| ||||| ||| | | |||#||||| |
|###|     |         |     |## |     | |   |###### |
| ||| |||||||||||||||||||||#| ||||||| ||| |#    # |
|   |                 ######|##         |    ##   |
|||||||||||||||||||||||||||||||||||||||||||||||||||
